11111111111
10a00000011
10111111011
10100001011
10101111011
10000000b11
11111111110